26 18
1 1 1 1 1 1 1 1 1 1 1 1 1 1 1 1 1 1 1 1 1 1 1 1 1 1
1 0 0 0 0 0 0 0 0 0 0 0 0 1 0 0 0 0 0 0 0 0 0 0 0 1
1 0 1 1 1 0 1 0 1 1 0 1 0 1 0 1 0 1 0 1 0 1 1 1 7 1
1 0 1 0 0 7 1 0 1 0 0 1 0 1 0 0 0 0 0 0 0 0 0 0 0 1
1 0 1 0 1 1 1 0 0 0 0 0 0 0 0 0 0 0 0 1 0 1 1 0 1 1
1 0 0 0 0 0 0 0 1 1 0 1 0 0 1 0 1 1 0 1 0 0 1 0 0 1
1 0 1 0 1 0 1 0 1 0 0 1 0 0 1 0 0 1 0 1 0 0 1 0 1 1
1 0 1 0 0 0 1 0 0 0 0 0 0 0 0 0 0 0 0 0 0 0 1 0 0 1
1 0 1 1 0 1 1 0 1 0 2 2 4 4 2 2 0 1 0 1 0 0 0 0 1 1
1 0 0 0 0 0 0 0 1 0 2 3 3 3 3 2 0 0 0 1 0 0 1 0 0 1
1 0 1 1 1 1 1 0 0 0 2 3 3 3 3 2 0 1 0 0 0 0 1 0 1 1
1 0 0 0 0 0 1 0 1 0 2 2 2 2 2 2 0 1 0 1 0 0 1 0 1 1
1 0 1 0 1 0 1 0 1 0 0 0 8 0 0 0 0 1 0 0 0 0 0 0 0 1
1 0 1 1 1 0 1 0 0 0 1 1 1 1 1 1 0 1 0 1 0 0 1 1 1 1
1 0 1 0 1 0 1 0 1 0 0 0 0 0 0 0 0 1 0 1 0 0 1 0 0 1
1 0 0 0 0 0 1 0 1 1 0 1 0 0 1 0 1 1 0 1 0 0 0 0 0 1
1 0 0 7 0 0 0 0 0 0 0 0 0 0 0 0 0 0 0 0 0 0 0 1 7 1
1 1 1 1 1 1 1 1 1 1 1 1 1 1 1 1 1 1 1 1 1 1 1 1 1 1
4 2

